1111111111111111111111111111111
1000000000000000000000000000001
1000000C0000000A00000000C000001
1000000000000000000000000000001
100000001000000P000000000100001
1000000000000A00000000001100001
100C000000010000000A00000000001
1000000001111000000000000000001
100000000001000010000100000C001
1000A0000000000E100000000000001
1000000C00000000000011000000001
10000000010000000000C1000000001
100000000000C00000000A000000001
1111111111111111111111111111111
