111111111111111111111
1P00010C0010C001000C1
10000100001A000100001
100001A0001000A100A01
100000000000000000001
100000000000000000001
1000A1000A10000100001
10000100001000010A001
10C001000C100001000E1
111111111111111111111
