111111111111111111111
1P000100C0100C0100C01
100001000010000100001
100001000010000100001
1A0000000000000000001
101111111011111001111
1A0000000000000000001
111111011111110111111
100001000010000100001
1A0000000000000000001
100001000010000100001
1000C10000100001000E1
111111111111111111111
