1111111111111111111111111111111111111
1P00000000000000000000000000000000001
10000000000000000000000C0000000000001
1000011111111111100000000000000000001
1000000000011111111110000000000000001
100000000000000000000000000000C000001
1000000000C00000000000000000000000001
1000000000000000000000111110000000001
1000000000000000000000000000000000001
1000000000000000000000000000000000001
100000000111111111000000000000C000001
1000000000000000000000000000000000001
1000000000000000000000000000000000001
10000000C0000000000000000000000000001
1000000000000000000000000000000000001
1000000000000000000111111100000000001
1000000000000000000000000000000000001
100000000000000000000000000C000000001
10000000000000000000000000000000000E1
1111111111111111111111111111111111111
